00000000000000001111111111111111100000000000000000
00000000000000001111111111111111100000000000000000
00000000000000001112222222222211100000000000000000
00000000001111111112222222222211111111111111100000
00000000001000001112222222222211100000000000100000
00000000001000001111111111111111100000000000100000
00000000001000001111111111111111100000000000100000
00000000001000000000011444110000000000000000100000
00000000001000000000011434110000000000001111100000
00000000001000000000011434110000000001111000000000
00000000001000000000011434110000000001000000000000
00000000001000000000011333111100000001100000000000
00000000001000000000011111110111000000100111110000
01111111111000000000011111110001000011100100010000
01000000001000000000000010000001110010000100010000
01000000001000000000000111000000011110000100010000
01000000001000000000000141000000001011110100010000
01000000001111111111111131000000001000011100110000
01000000001000000000000141000001111111000000100000
01000000001000000000000131000001333331000000100000
01011111111111111110000141000001333331000000100000
01011111111111111110000111000001333331000000110000
01011334433443344110000010000001111111000000010000
01011334433443344111111111000000001000000000010000
01111111111111111111111111111111111111111111110000
00011111111111111111111111000000000000000000010000
00011443344334433110000000000000000000000000110000
00011443344334433110000111111111111100000000100000
00011111111111111111111111111111111100000000100000
00011111111111111110000111111111111100000000100000
00000000111110000000000111100000011100000000100000
00000000111110000000001111110000011100000000100000
00000000111111111111111111110000011100000000100000
00000000111111111111111111110000011100000000100000
00000000000000000000001111110000011100000000100000
00000000000000000000001133110000001000000000110000
00000000000000000000001133110000001000000000010000
00000000000000000000001133110000001000000000010000
00000000000000000000001111110000001000000000010000
00000000000000000000001111110000001000000000110000
00000000000000000000001111110000001111111111100000
00000000000000000000001111110000001000000000100000
00000000000000000000001511510000001000000000110000
00000000000000000000001111110000001000000000010000
00000000000000000000001111110000001000000000010000
00000000000000000000001511510000001000000000010000
00000000000000000000001111110000001000000000010000
00000000000000000000000000000000001111111111110000
00000000000000000000000000000000000000000000000000
00000000000000000000000000000000000000000000000000