00000000000000000000002222200000000000000000000000
00000000000000000000002222200000000000000000000000
00000000000000000000000111000000000000000000000000
00000000000000000000000111000000000000000000000000
00000000000000000000000111000000000000000000000000
00000000000000000000000111000000000000000000000000
00000000000000000000000111000000000000000000000000
00000000000000000000000111000000000000000000000000
00000000000000000000000111000000000000000000000000
00000000000000000000000111000000000000000000000000
00000000000000000000000111000000000000000000000000
00000000000000000000000111000000000000000000000000
00000000000000000000000111000000000000000000000000
00000000000000000000000111000000000000000000000000
00000000000000000000000111000000000000000000000000
00000000000000000000000111000000000000000000000000
00000000000000000000000111000000000000000000000000
00000000000000000000000111000000000000000000000000
00000000000000000000000111000000000000000000000000
00001111111111111111111111000000000000000000000000
00001111111111111111111111000000000000000000000000
00001110000000000000000000000000000000000000000000
00001110000000000000000000000000000000000000000000
00001110011111111111111111111111111111111000000000
00001110011333111444111111111333111444111000000000
00001110011333111444111111111333111444111000000000
00001111111333111444111111111333111444111000000000
00001111111111111111111111111111111111111000000000
00001111111444111333111111111444111333111000000000
00000000011444111333111111111444111333111000000000
00000000011444111333111111111444111333111000000000
00000000011111111111111111111111111111111000000000
00000000000000000111111111111111000000000000000000
00000000000000000111111111111111000000000000000000
00000000000000000111111111111111000000000000000000
00000000000000000111111111111111000000000000000000
00000000000000000111111111111111000000000000000000
00000000000000000111111111111111000000000000000000
00000000000000000111111111111111000000000000000000
00000000000000000000000000000000000000000000000000
00000000000000000000000000000000000000000000000000
00000000000000000000000000000000000000000000000000
00000000000000000000000000000000000000000000000000
00000000000000000000000000000000000000000000000000
00000000000000000000000000000000000000000000000000
00000000000000000000000000000000000000000000000000
00000000000000000000000000000000000000000000000000
00000000000000000000000000000000000000000000000000
00000000000000000000000000000000000000000000000000
00000000000000000000000000000000000000000000000000